..........
..........
....#.....
...#.#....
...#.#....
....#.....
..........
..........
..........
..........